        11111111111111111111111111111111
    11111                              111111
11111                                       1111
1                                              1
1                                              1
1                                              1
1                                              1
1                                              1
1                                              1
1                                              1
1                                              1
1                                              1
1                                              1
1                                              1
1                                              1
1                                             11
1                                          3111
1                                        1111
1                 4       4      4    111111
1111111111111111111111111111111111111111111