        111111111111111111111111111111111111
    11111                                  111111
11111                                           11111
1                                                   1
1                                                   1
1                                                   1
1                                                   1
1                                                   1
1                                                   1
1                                                   1
1                                                   1
1                                                   1
1                                                   1
1             4                                     1
1           11111                                   1
1                                                  11
1         1                                      3111
1        11          4    4      11           111111
1111111111111111111111    1111111111111111111111
     11111111111111111555511111111111111111