        111111111111111111111111111111111111
    11111                                  111111
11111                                           11111
1                                                   1
1                                                   1
1                                                   1
1                                                   1
1                                                   1
1                                                   1
1                                                   1
1                                                   1
1                                                   1
1                                                   1
1                                                   1
1                                                   1
1                  4                               31
1                 11               4             111
1               1111              111          1111
1             111111     11      1111155551111111
11111111111111111111     11    11111111111111