22222222222222222222222222222222222222222222222222222222
1                                                      1
10000000000000000000000000000000000000000000000000000001
10000000000000000000000000000000000000000000000000000001
10000000000000000000000000000000000000000000000000000001
10000000000000000000000000000000000000000000000000000001
10000000000000000000000000000000000000000000000000000001
10000000000000000000000000000000000000000000000000000001
10000000000000000000000000000000000000000000000000000001
10000000000000000000000000000000000000000000000000000001
10000000000000000000000000000000000000000000000000000001
10000000000000000000000000000000000000000000000000000001
10000000000000000000000000000000000000000000000000000001
10000000000000000000000000000000000000000000000000000001
10000000000000000000000000000000000000000000000000000001
10000000000000000000000000000000000000000000000000000001
10000000000000000000000100000001000000000000001100000301
10000000000000000000001110000011100000010000011110000101
10000000000000000000011111111111110000110000111111000101
11111111111111111111111111111111111111111111111111111111