        111111111111111111111111111111111111
    11111                                  111111
11111                                           11111
1                                                   1
1                                                   1
1                                                   1
1                                                   1
1                                                   1
1                                                   1
1                                                   1
1                                                   1
1                                                   1
1                                                   1
1             4                                     1
1           11111                                   1
1           2                             3        11
1         122                             1      3111
1        11          4    4      11       1    11111
1111111111111111111111    111122111   111111111111
     11111111111111111555511111111155511111