2222222222222222222222222222222222222222
0000000000000000000000000000000000000000
0000000000000000000000000000000000000000
0000000000000000000000000000000000000000
0000000000000000000000000000000000000000
0000000000000000000000000000000000000000
0000000000000000000000000000000000000000
0000000000000000000000000000000000000000
0000000000000000000000000000000000000000
0000000000000000000000000000000000000000
2000000000000000000000000000000000000000
2000000000000000000000100000000000000000
2000000000000000000001110000000000000000
1111111111111111111111111111111111111111