2222222222222222222222222222222222222222
2000000000000000000000000000000000000000
2000000000000000000000000000000000000000
2000000000000000000000000000000000000000
2000000000000000000000000000000000000000
2000000000000000000000000000000000000000
2000000000000000000000000000000000000000
2000000000000000000000000000000000000000
2000000000000000000000000000000000000000
2000000000000000000000000000000000000000
2000000000000000000000010000000000000000
2000000000000000000000111000000000000000
2000000000000000000001111100000000000000
1111111111111111111111111111111111111111