1111111111111111111111111111111111111
0000000000000000000000000000000000000
0000000000000000000000000000000000000
0000000000000000000000000000000000000
0000000000000000000000000000000000000
0000222200000000000000000000022200000
0000222220000000000000000000022220000
2222222222222222222222222222222222222